1111111111111111111
1004000400040004001
1011101011101011101
1410141000001410141
1011101410141011101
1000001010101000001
1011111000001111101
1410400000000040141
1000111114111110001
1000400004000040001
1011110011100111101
1004000410140004001
1011101011101011101
1010101004001010101
1011101011101011101
1400041410141400041
1411111011101111141
1000000233300000001
1111111111111111111